#  #  #  #  #  #  #
#  #  # 11 10  9  #
#  #  #  #  #  8  #
# 15 14 13 12  7  #
#  #  #  #  6  #  #
#  1  2  3  4  5  #
#  #  #  #  #  #  #